11111
1CPP1
101E1
10C01
11111
