11111
1CPE1
101E1
10C01
11111
