11111
1C111
101E1
10C01
11111
