11111
1CP01
10101
10C01
11111
