1111111
10001E1
1C1C011
10001C1
10C0001
10010P1
1111111
