1111111
10000E1
1110001
1000101
1000001
10010P1
1111111
