11111
1C0P1
101E1
10C01
11111
