1111111
10000E1
1C1C001
10001C1
10C0001
10010P1
1111111
