111111
1C01C1
10C101
100P01
1010C1
101E11
1C0001
111111
