11111111111111
100C010C1000C1
1010110010C001
10000110001011
100001C0011001
101C0000001101
1P10000E001C01
11111111111111
