1111111
1E10C01
1010111
1010001
1C10P01
10C0001
10111C1
10C0001
1101011
10010C1
1C01001
1111111
