11111111111
10000P000C1
101C1010101
10010101C11
1C000000001
100C010C001
100000000C1
11C101C1001
10101010101
1C000E0C001
11111111111

