1111111111111111111111111111
1E100001C0000C00000P00000001
101100010000000000000C000001
101100010000000000000C000001
100000010000C001110C00100101
1C00111111000001C10001001001
1000100000001101010000000C01
100010C000001C010000C0000101
10C010000C101111100000101001
100000001111C010000001000001
1000000010100000001000000001
11111C001C000000000000010101
10C01000000000C000C000010101
1000100C0001010101010C0101C1
100000000000C000C0000001C101
1111111111111111111111111111
