11111
1C0P1
100E1
10CC1
11111
